####################°
#  #############  ##°
#  #############  ##°
#  #############  ##°
##  ############  ##°
###              ###°
###      #       ###°
###  ~   #   ~   ###°
### #    #    # ####°
####    ###    #####°
#####         ######°
######  ###  #######°
#######  #   #######°
######        ######°
######  # #   ######°
###### # # #  ######°
######        ######°
####################°
####################°
####################°
°°°°°°°°°°°°°°°°°°°°°

8,6 "Wall" ""
8,14 "Wall" ""
